1111111111
1P00000001
1011111101
1000000101
1011100101
1000100101
1010100101
1C001000E1
1111111111
1111111111
